REB = "countries/rebels.txt"
PIR = "countries/pirates.txt"
BAR = "countries/barbarians.txt"
MER = "countries/mercenaries.txt"

# Greece/Macedonia
#CRT = "countries/crete.txt"

# Ireland
DUB = "countries/ireland/dublin.txt"
CON = "countries/ireland/connacht.txt"
BEL = "countries/ireland/belfast.txt"
CLI = "countries/ireland/cliffs.txt"
ULS = "countries/ireland/ulster.txt"
COR = "countries/ireland/cork.txt"
LIM = "countries/ireland/limerick.txt"
MEA = "countries/ireland/meath.txt"
DER = "countries/ireland/derry.txt"
LEI = "countries/ireland/leinster.txt"

# England

LON = "countries/england/london.txt"
WIN = "countries/england/windsor.txt"
WES = "countries/england/westcountry.txt"
CUM = "countries/england/cumbria.txt"
MAN = "countries/england/mann.txt"
LAN = "countries/england/lancashire.txt"
YOR = "countries/england/yorkshire.txt"
LIV = "countries/england/liverpool.txt"
MAR = "countries/england/manchester.txt"
ANG	= "countries/england/anglia.txt"
CAM = "countries/england/cambridge.txt"

# Scotland

ABE = "countries/scotland/aberdeen.txt"
EDI = "countries/scotland/edinburgh.txt"
GLA = "countries/scotland/glasgow.txt"
ISL = "countries/scotland/scottishisles.txt"
DUM = "countries/scotland/dumfries.txt"
HIG = "countries/scotland/highlands.txt"

# Italy #

# France #

BRI = "countries/france/brittany.txt"

# Germany #

# Switzerland
SWI = "countries/switzerland/switzerland.txt"

#New:
ATH = "countries/greece/athens.txt"
SPA = "countries/greece/sparta.txt"
EPI = "countries/greece/epirus.txt"
KRK = "countries/greece/korkyra.txt"
AET = "countries/greece/aetolia.txt"
AKR = "countries/greece/akarnania.txt"
MSE = "countries/greece/messenia.txt"
PTA = "countries/greece/patrai.txt"
MGL = "countries/greece/megalopolis.txt"
AIG = "countries/greece/aigon.txt"
AZA = "countries/greece/azania.txt"
ARG = "countries/greece/argos.txt"
MTE = "countries/greece/mantinea.txt"
ELI = "countries/greece/elis.txt"
#COT = "countries/greece/corinth.txt"
TRN = "countries/greece/troizen.txt"
EPD = "countries/greece/epidauros.txt"
PRI = "countries/greece/prasiai.txt"
HRA = "countries/greece/heraia.txt"
LPR = "countries/greece/lepreon.txt"
MAC = "countries/greece/macedonia.txt"
STP = "countries/greece/stymphalia.txt"
MGA = "countries/greece/megara.txt"
THE = "countries/greece/thebes.txt"
EUB = "countries/greece/euboea.txt"
BOE = "countries/greece/boeotia.txt"
DEL = "countries/greece/delos.txt"
ADR = "countries/greece/andros.txt"
KOS = "countries/greece/kos.txt"
MLO = "countries/greece/miletos.txt"
BYZ = "countries/greece/byzantion.txt"
ION = "countries/anatolia/ionian_league.txt"
CIA = "countries/anatolia/caria.txt"
KNI = "countries/anatolia/knidos.txt"
IOA = "countries/anatolia/aeolia.txt"
CDD = "countries/anatolia/calchedon.txt"
KIO = "countries/anatolia/kios.txt"
SNP = "countries/anatolia/sinope.txt"
AST = "countries/anatolia/astakos.txt"
KZK = "countries/anatolia/kyzikos.txt"
AMS = "countries/anatolia/amisos.txt"
HKS = "countries/anatolia/halikarnassos.txt"
KRS = "countries/anatolia/kerasous.txt"
KYA = "countries/anatolia/kotyora.txt"
PAA = "countries/greece/paeonia.txt"


# Crimea and Abkhazia

BPK = "countries/greece/bosporus.txt"
SRM = "countries/greece/sarmatians.txt"
OLB = "countries/greece/olbia.txt"
TYS = "countries/greece/tyras.txt"
TYG = "countries/greece/tyrgetae.txt"
MAE = "countries/greece/maeotia.txt"
CHS = "countries/greece/chersonesus.txt"
ISO = "countries/greece/istros.txt"
SND = "countries/caucasiamesopotamia/sindica.txt"
SCE = "countries/caucasiamesopotamia/siracia.txt"
LGA = "countries/caucasiamesopotamia/legia.txt"
SCA = "countries/caucasiamesopotamia/scythia.txt"
#

KNO = "countries/greece/knossos.txt"
PYR = "countries/greece/polyrrhenia.txt"
LYT = "countries/greece/lyctus.txt"
KYD = "countries/greece/kydonia.txt"
GRT = "countries/greece/gortyna.txt"
IEP = "countries/greece/ierapetra.txt"
TRA = "countries/greece/tarra.txt"
PRE = "countries/greece/praesos.txt"
ELT = "countries/greece/eleutherna.txt"

## Thracia/Illyria
TRE = "countries/greece/thrace.txt"
ODR = "countries/greece/odrysia.txt"

## Asia Minor

#New
PRY = "countries/anatolia/phrygia.txt"
RHO = "countries/anatolia/rhodes.txt"
BIT = "countries/anatolia/bithynia.txt"
HCP = "countries/anatolia/heraclea_pontica.txt"
CAP = "countries/anatolia/cappadocia.txt"
PON = "countries/anatolia/pontus.txt"
PAP = "countries/anatolia/paphlagonia.txt"

#New
SEL = "countries/caucasiamesopotamia/seleucid empire.txt"
ADI = "countries/caucasiamesopotamia/adiabene.txt"
ARM = "countries/caucasiamesopotamia/armenia.txt"
MAP = "countries/caucasiamesopotamia/media atropatene.txt"
IBR = "countries/caucasiamesopotamia/iberia.txt"
COL = "countries/caucasiamesopotamia/colchis.txt"
ALB = "countries/caucasiamesopotamia/albania.txt"
TRZ = "countries/caucasiamesopotamia/trapezous.txt"
BAC = "countries/bactria/bactria.txt"
PAR = "countries/caucasiamesopotamia/parthia.txt"

# Arabia/Persia
OSR = "countries/syria/osroene.txt"
SOP = "countries/syria/sophene.txt"

#Syria
COM = "countries/syria/commagene.txt"
JUD = "countries/syria/judea.txt"
SMA = "countries/syria/samaria.txt"
BYB = "countries/syria/byblos.txt"
ARA = "countries/syria/arados.txt"
SID = "countries/syria/sidon.txt"
BMB = "countries/syria/bambyce.txt"

####SULLA####

# Italic

ROM = "countries/italia/rome.txt"
SAM = "countries/italia/samnium.txt"
ETR = "countries/italia/etruscia.txt"
UMB = "countries/italia/umbria.txt"
PIE = "countries/italia/picentes.txt"
SAB = "countries/italia/sabinia.txt"
APU = "countries/italia/apulia.txt"
NEP = "countries/italia/neapolis.txt"
FRE = "countries/italia/frentani.txt"
PEL = "countries/italia/peligni.txt"
MSP = "countries/italia/messapii.txt"
SNI = "countries/italia/senonii.txt"
LCA = "countries/italia/lucania.txt"
BRT = "countries/italia/bruttia.txt"
ANO = "countries/italia/ancona.txt"
MET = "countries/italia/metapontum.txt"
TAR = "countries/italia/tarentum.txt"
THU = "countries/italia/thurii.txt"
HCL = "countries/italia/heracleia.txt"
CRO = "countries/italia/croton.txt"
LOC = "countries/italia/locri.txt"
RHG = "countries/italia/rhegium.txt"
HPO = "countries/italia/hipponium.txt"
SCU = "countries/italia/siculia.txt"
LGN = "countries/italia/lingones.txt"
TAU = "countries/italia/taurini.txt"
INM = "countries/italia/intimili.txt"
IGN = "countries/italia/ingauni.txt"
EPA = "countries/italia/epanterii.txt"
INS = "countries/italia/insubri.txt"
CNM = "countries/italia/cenomanni.txt"
KRN = "countries/italia/carni.txt"
VNT = "countries/italia/veneti.txt"
HIS = "countries/italia/histri.txt"
GUN = "countries/italia/genuates.txt"
BOI = "countries/italia/boi.txt"
RAE = "countries/italia/raeti.txt"
FNT = "countries/italia/friniati.txt"
NUC = "countries/italia/nocera.txt"
MRS = "countries/italia/marsia.txt"
SIO = "countries/italia/sipontum.txt"
SYR = "countries/italia/syracusae.txt"
ACR = "countries/italia/acragas.txt"


#Iberian

ASU = "countries/iberia/astures.txt"
AUI = "countries/iberia/ausetani.txt"
AUG = "countries/iberia/autrigones.txt"
BAI = "countries/iberia/bastetani.txt"
BAL = "countries/iberia/bastuli.txt"
CLL = "countries/iberia/callaeci.txt"
CBI = "countries/iberia/cantabri.txt"
CRI = "countries/iberia/caristii.txt"
CRP = "countries/iberia/carpetani.txt"
CLB = "countries/iberia/celtiberi.txt"
CLC = "countries/iberia/celtici.txt"
CNT = "countries/iberia/contestani.txt"
CNU = "countries/iberia/couneii.txt"
EDT = "countries/iberia/edetani.txt"
ICV = "countries/iberia/ilercavones.txt"
ILG = "countries/iberia/ilergetes.txt"
IDK = "countries/iberia/indiketes.txt"
LCT = "countries/iberia/lacetani.txt"
ORT = "countries/iberia/oretani.txt"
TUR = "countries/iberia/turdetani.txt"
VCI = "countries/iberia/vaccaei.txt"
VSC = "countries/iberia/vascones.txt"
VET = "countries/iberia/vettones.txt"
EPO = "countries/iberia/emporion.txt"
#MLK = "countries/iberia/malaka.txt"
TAT = "countries/iberia/tartessos.txt"
MST = "countries/iberia/menesthei.txt"
GAD = "countries/iberia/gadir.txt"
MAT = "countries/iberia/mastia.txt"
#CTI = "countries/iberia/carteia.txt"
SGS = "countries/iberia/saguntines.txt"
ORM = "countries/iberia/orgenomesci.txt"
AVG = "countries/iberia/avarigini.txt"
COC = "countries/iberia/concani.txt"
CNI = "countries/iberia/conisci.txt"
BLN = "countries/iberia/blendii.txt"
MRC = "countries/iberia/morecani.txt"
TMC = "countries/iberia/tamarici.txt"
VDI = "countries/iberia/vadini.txt"
AMC = "countries/iberia/amaci.txt"
BDU = "countries/iberia/bedunienses.txt"
GGR = "countries/iberia/gigurri.txt"
LCN = "countries/iberia/lancienses.txt"
LGO = "countries/iberia/lugones.txt"
PSC = "countries/iberia/paesici.txt"
SLI = "countries/iberia/selini.txt"
SPT = "countries/iberia/superatii.txt"
TBU = "countries/iberia/tiburi.txt"
ZLA = "countries/iberia/zoelae.txt"
AEB = "countries/iberia/aebocosi.txt"
ABO = "countries/iberia/albiones.txt"
ARR = "countries/iberia/arroni.txt"
BED = "countries/iberia/baedi.txt"
BAN = "countries/iberia/banienses.txt"
BRC = "countries/iberia/bracari.txt"
CLD = "countries/iberia/caladuni.txt"
COP = "countries/iberia/copori.txt"
GRV = "countries/iberia/gravi.txt"
INT = "countries/iberia/interamici.txt"
LUN = "countries/iberia/leuni.txt"
NRI = "countries/iberia/neri.txt"
SUR = "countries/iberia/seurri.txt"
SLN = "countries/iberia/sileni.txt"
TMG = "countries/iberia/tamagani.txt"
VRR = "countries/iberia/varrini.txt"
CSS = "countries/iberia/cessetani.txt"
TDL = "countries/iberia/turduli.txt"
PAE = "countries/iberia/paesuri.txt"
LSI = "countries/iberia/lusitani.txt"
TPL = "countries/iberia/tapoli.txt"
SFI = "countries/iberia/sefia.txt"
CMS = "countries/iberia/cempsia.txt"
TDT = "countries/iberia/oppidania.txt"
EBL = "countries/iberia/elbocori.txt"
IGD = "countries/iberia/igaedetania.txt"
LCC = "countries/iberia/lanciencia.txt"
AVA = "countries/iberia/aravia.txt"
TLS = "countries/iberia/taluria.txt"
BDL = "countries/iberia/bardulia.txt"
TDI = "countries/iberia/turmodigia.txt"
AVC = "countries/iberia/arevacia.txt"
BLT = "countries/iberia/bletonisia.txt"
CLU = "countries/iberia/caluria.txt"
CRE = "countries/iberia/coerensia.txt"
CLO = "countries/iberia/calontiensia.txt"
LSN = "countries/iberia/lusonia.txt"
TTH = "countries/iberia/tithia.txt"
BLL = "countries/iberia/bellia.txt"
BOL = "countries/iberia/boletia.txt"
OLC = "countries/iberia/olcadia.txt"
LBT = "countries/iberia/lobetania.txt"
DNQ = "countries/iberia/duniquia.txt"
MOC = "countries/iberia/moeniccia.txt"
AEL = "countries/iberia/aelariquia.txt"
TRQ = "countries/iberia/tirtaliquia.txt"
DOA = "countries/iberia/duitiquia.txt"
SLC = "countries/iberia/solicia.txt"
SDT = "countries/iberia/sedetania.txt"
DEI = "countries/iberia/deitania.txt"
EBI = "countries/iberia/eburania.txt"
MTS = "countries/iberia/mantesania.txt"
GRM = "countries/iberia/garmania.txt"

#African

CAR = "countries/africa/carthage.txt"
EGY = "countries/africa/egypt.txt"
MSS = "countries/africa/massaesylia.txt"
MSY = "countries/africa/massylia.txt"
CYR = "countries/africa/cyrenaica.txt"
MSL = "countries/africa/musulami.txt"
MAU = "countries/africa/mauretania.txt"
KSH = "countries/africa/kush.txt"
AXM = "countries/africa/aksum.txt"
MYL = "countries/africa/mosylon.txt"
OPO = "countries/africa/opone.txt"
MND = "countries/africa/mundus.txt"
AVL = "countries/africa/avalites.txt"
ADO = "countries/africa/adouli.txt"
YEH = "countries/africa/yeha.txt"
GWN = "countries/africa/gwanara.txt"
BOR = "countries/africa/boras.txt"
AUT = "countries/africa/alut.txt"
BMY = "countries/africa/blemmyes.txt"
ACO = "countries/africa/achola.txt"
HDR = "countries/africa/hadrametum.txt"
LPT = "countries/africa/leptis.txt"
TPS = "countries/africa/thapsus.txt"
UTC = "countries/africa/utica.txt"
TRP = "countries/africa/tripolitania.txt"
EMP = "countries/africa/emporia.txt"
IOL = "countries/africa/iol.txt"
KUA = "countries/africa/kerkouane.txt"
DOD = "countries/africa/dodekaschoinos.txt"

#Gaul

#Illyria and Dacia
CAA = "countries/illyria_dacia/catari.txt"
DRI = "countries/illyria_dacia/daorsi.txt"
DLM = "countries/illyria_dacia/delmatae.txt"
DIT = "countries/illyria_dacia/iapodes.txt"
LTB = "countries/illyria_dacia/latobici.txt"
LBN = "countries/illyria_dacia/liberni.txt"
PII = "countries/illyria_dacia/pieri.txt"
BCI = "countries/illyria_dacia/breuci.txt"
ABI = "countries/illyria_dacia/abrii.txt"
CVI = "countries/illyria_dacia/cavii.txt"
DUI = "countries/illyria_dacia/deuri.txt"
PNN = "countries/illyria_dacia/pannoni.txt"
DNT = "countries/illyria_dacia/ditiones.txt"
DND = "countries/illyria_dacia/dindari.txt"
SCD = "countries/illyria_dacia/scordici.txt"
AMI = "countries/illyria_dacia/armistae.txt"
OXU = "countries/illyria_dacia/oxuaioi.txt"
OTN = "countries/illyria_dacia/cotini.txt"
HCN = "countries/illyria_dacia/hercuniati.txt"
EVS = "countries/illyria_dacia/eravisci.txt"
TLT = "countries/illyria_dacia/tilataei.txt"
MOE = "countries/illyria_dacia/moesi.txt"
TBL = "countries/illyria_dacia/triballoi.txt"
GTE = "countries/illyria_dacia/getae.txt"
POT = "countries/illyria_dacia/potulatenses.txt"
SLD = "countries/illyria_dacia/saldenses.txt"
ABN = "countries/illyria_dacia/albocenses.txt"
BUD = "countries/illyria_dacia/buridavenses.txt"
RAT = "countries/illyria_dacia/ratacenses.txt"
APP = "countries/illyria_dacia/appuli.txt"
CAC = "countries/illyria_dacia/caucoenses.txt"
ANS = "countries/illyria_dacia/ansamenses.txt"
TYR = "countries/illyria_dacia/tyrgetae.txt"
NRC = "countries/illyria_dacia/norici.txt"
TSC = "countries/illyria_dacia/taurisci.txt"
TLN = "countries/illyria_dacia/taulantii.txt"
DRD = "countries/illyria_dacia/dardani.txt"
SDI = "countries/illyria_dacia/serdi.txt"

#Arabia
SHB = "countries/arabia/sheba.txt"
MIN = "countries/arabia/ma'in.txt"
QTB = "countries/arabia/qataba.txt"
HDM = "countries/arabia/hadhramut.txt"
HMJ = "countries/arabia/himjar.txt"
NBT = "countries/arabia/nabatea.txt"
LHY = "countries/arabia/lihyan.txt"
MAK = "countries/arabia/maka.txt"
TYO = "countries/arabia/tylos.txt"
GRH = "countries/arabia/gerrha.txt"
TQF = "countries/arabia/thaqif.txt"
THD = "countries/arabia/thamud.txt"
QDA = "countries/arabia/qadaritia.txt"

#India/Tibet
SHU = "countries/india/shule.txt"
PHY = "countries/india/phryni.txt"
WUS = "countries/india/wusun.txt"
TAY = "countries/india/tayuan.txt"
SOG = "countries/india/sogdia.txt"
KHT = "countries/india/khotan.txt"
LOL = "countries/india/loulan.txt"
KSA = "countries/india/kusan.txt"
PSH = "countries/india/pishan.txt"
PND = "countries/india/pandyas.txt"
CHR = "countries/india/cheras.txt"
AYY = "countries/india/ay.txt"
CHL = "countries/india/cholas.txt"
STY = "countries/india/satiyaputa.txt"
ANU = "countries/india/anuradhapura.txt"
MSH = "countries/india/mahisha.txt"
ASM = "countries/india/ashmaka.txt"
ANH = "countries/india/andhra.txt"
KAL = "countries/india/kalinga.txt"
PIT = "countries/india/pitinika.txt"
BOJ = "countries/india/bhoja.txt"
KUN = "countries/india/kuntala.txt"
ALU = "countries/india/alupa.txt"
RTI = "countries/india/rathikas.txt"
KRP = "countries/india/kamarupa.txt"
IDR = "countries/india/indravana.txt"
KRA = "countries/india/karusa.txt"
ZHZ = "countries/india/zhangzhung.txt"
YRL = "countries/india/yarlung.txt"
SMP = "countries/india/sumpa.txt"
TSA = "countries/india/tsang.txt"
ATV = "countries/india/atavia.txt"

#Germanic
BST = "countries/germania/bastarnae.txt"
SXS = "countries/germania/saxones.txt"
CMB = "countries/germania/cimbria.txt"
VDL = "countries/germania/aetelrugia.txt"
TIT = "countries/germania/teutonia.txt"
GIT = "countries/germania/gutonia.txt"
SWE = "countries/germania/suionia.txt"
RUG = "countries/germania/grania.txt"
RAM = "countries/germania/raumaricia.txt"
HRE = "countries/germania/herules.txt"
VRI = "countries/germania/varinia.txt"
LGI = "countries/germania/lugia.txt"
AES = "countries/germania/aestia.txt"
LVA = "countries/germania/lemovia.txt"
SMN = "countries/germania/semnonia.txt"
LGB = "countries/germania/langobardia.txt"
MCM = "countries/germania/marcomannia.txt"
CHC = "countries/germania/chaucia.txt"

#Bactrian
PRN = "countries/bactria/parni.txt"
ZNT = "countries/bactria/zanthi.txt"
PSS = "countries/bactria/pissuri.txt"
KRZ = "countries/bactria/kharesmia.txt"

#Extra Crimea
SCY = "countries/greece/scythia_europea.txt"
ZGY = "countries/caucasiamesopotamia/zygia.txt"
HNY = "countries/caucasiamesopotamia/heniochia.txt"
PHI = "countries/caucasiamesopotamia/phasis.txt"

#Extra Germany
BUR = "countries/germania/burgundia.txt"
DAN = "countries/germania/dania.txt"
LEU = "countries/germania/leuonia.txt"
GTH = "countries/germania/gothonia.txt"
RGG = "countries/germania/rugiagermania.txt"
SCI = "countries/germania/sciria.txt"
FOS = "countries/germania/fosia.txt"
REU = "countries/germania/reudignia.txt"
AVO = "countries/germania/aviones.txt"
CRS = "countries/germania/cherusci.txt"
EUD = "countries/germania/eudosi.txt"
AGR = "countries/germania/angrivaria.txt"

#Nuragic
IOI = "countries/nuragic/iolensia.txt"
BLR = "countries/nuragic/balaria.txt"
